xxxxxxxxxxxxxxxxxxxx
x      x   x   x   x
x      x   x   x   x
xxxxx xxx xxx xxx xx
x                  x
x                  x
xxxxxxx xxxxxxxxx  x
x     x x          x
x     x x       x  x
x     x x s     x  x
x     x xxxxxxxxx  x
x                  x
x     xxxxxx  xxxxxx
x     x            x
x     x            x
xxxxxxx   xxxxxxxxxx
x                  x
x                  x
x                  x
xxxxxxxxxxxxxxxxxxxx